0000000000000000
0000000000000000
0000000000000000
0000000000000000
0000001110000000
0000001210000000
0000001011110000
0000111303210000
0000120341110000
0000111131000000
0000000121000000
0000000111000000
0000000000000000
0000000000000000
0000000000000000
0000000000000000

0000000000000000
0000000000000000
0000000000000000
0000111110000000
0000140010000000
0000103310111000
0000103010121000
0000111011121000
0000011000021000
0000010001001000
0000010001111000
0000011111000000
0000000000000000
0000000000000000
0000000000000000
0000000000000000 

0000000000000000
0000000000000000
0000000000000000
0000000000000000
0000111111100000
0000100000111000
0001131110001000
0001040300301000
0001022103011000
0001122100010000
0000111111110000
0000000000000000
0000000000000000
0000000000000000
0000000000000000
0000000000000000

0000000000000000
0000000000000000
0000000000000000
0000000000000000
0000011110000000
0000110010000000
0000143010000000
0000113011000000
0000110301000000
0000123001000000
0000122521000000
0000111111000000
0000000000000000
0000000000000000
0000000000000000
0000000000000000

0000000000000000
0000000000000000
0000000000000000
0000011111000000
0000014011100000
0000010300100000
0000111010110000
0000121010010000
0000123001010000
0000120003010000
0000111111110000
0000000000000000
0000000000000000
0000000000000000
0000000000000000
0000000000000000

0000000000000000
0000000000000000
0000111111100000
0111100000100000
0100021110100000
0101010000110000
0101030312010000
0101005001010000
0102130301010000
0110000101011100
0010111200004100
0010000011000100
0011111111111100
0000000000000000
0000000000000000
0000000000000000

0000000000000000
0000000000000000
0000000000000000
0000000000000000
0000000000000000
0000001111111000
0000011001041000
0000010001001000
0000013030301000
0000010311001000
0001110301011000
0001222220010000
0001111111110000
0000000000000000
0000000000000000
0000000000000000

0000000000000000
0000000000000000
0000000000000000
0000000000000000
0000001111110000
0000111000010000
0001120311011000
0001223030041000
0001220303011000
0001111110010000
0000000011110000
0000000000000000
0000000000000000
0000000000000000
0000000000000000
0000000000000000

0000000000000000
0000000000000000
0000000000000000
0001111111110000
0001001100010000
0001000300010000
0001301110310000
0001012221010000
0011012221011000
0010300300301000
0010000010401000
0011111111111000
0000000000000000
0000000000000000
0000000000000000
0000000000000000

0000000000000000
0000000000000000
0000000000000000
0000000000000000
0000000000000000
0000001111110000
0000001000010000
0000111333010000
0000140322010000
0000103222110000
0000111100100000
0000000111100000
0000000000000000
0000000000000000
0000000000000000
0000000000000000

